XXXXXXXX
X      X
X      X
X   F  X
X      2
X      X
X      X
XXXXXXXX
XXXXXXXX
X      X
X      3
X      X
1 F    X
X    z X
X      X
XXX5XXXX
XXXXXXXX
X  F   X
2      X
X      X
X      X
X      X
XF   z 4
XXXX6XXX
XXXXXXXX
X   K  X
X      X
X      X
X      X
X  z   X
3      X
XXXXXXXX
XXXX2XXX
X      X
X  F   X
X    z X
X      X
X  z   X
X      X
XXXXXXXX
XXXX3XXX
X      X
X      X
XxxxxxxX
X      X
X    z X
X      X
XXEXXXXX